11111111111
10010000001
10100000001
11000000001
10010000001
10100000001
10100000001
10100000N01
11111111111