11111111111
10010000001
10100000001
11000010001
10000000001
10101000001
10100000001
10100000N01
11111111111